0,0,0,4,1,5,0
0,0,0,4,1,5,0
0,0,0,4,1,5,0
2,2,2,8,1,5,0
3,3,3,6,1,5,0
0,0,0,4,1,5,0
0,0,0,4,1,5,0
0,0,0,4,1,5,0
